Size 12 10
Base 12 9
Spawn 0 5
┏━━━━━━━━━━━━┓
┃            ┃
┃            ┃
┃            ┃
┃  ╔════╗    ┃
┃  ║    ║    ┃
┃══╝    ║    ┃
┃       ║    ┃
┃       ║    ┃
┃       ║    ┃
┃       ╚════┃
┗━━━━━━━━━━━━┛