Size 12 10
Base 12 5
Spawn 0 5
┏━━━━━━━━━━━━┓
┃            ┃
┃            ┃
┃            ┃
┃  ╔════╗    ┃
┃  ║    ║    ┃
┃══╝    ╚════┃
┃            ┃
┃            ┃
┃            ┃
┃            ┃
┗━━━━━━━━━━━━┛
